xxxxRQOQQQOQQBORQQOQQB0R00OQQB0R00OQQB0R00OQQB0x
x00CPCP000P00P0P00P00P9P99P00P9P99P00P9P99P00POx
x00CPCO000J00nOS00J00nOS00J00nOS00J00nOS00J0000x
x00CPC0000P0000000P0000000P0000000P0000000P0000x
x00NNN0000O0000000O0000000O0000000O0000000O0000x
x000000000N0000000N0000000N0000000N0000000N00000
x00000000000000000000000000000000000000000000000
x00000000000000000000000000000000000000000000000
x000000000N00MLK00I00MLK00I00MLK00I00MLK00I00MLx
xROIIIOB00G0000000G0000000G0000000G0000000G0000x
xPROOOBP00G0000000G0000000G0000000G0000000G0000x
xPPNkNPP00H0OO0000H0000000H0000000H0000000H0000x
xOPIjIPO00G0000000G0J000J0G0J000J0G0J000J0G0000x
xnOSjnOSmmFmmmmmmmFQQQQQQQFxxxxx00FQQQQQQQFxxxxx
xxxxxxxxllGlllllllxxxxxxxxxxxxxxxxxxxxxxxxxxxxxx
















