uuttttttttttttuu
uw0DrrrrEEEED0uw
vux00000000000vu
uuy00000000000uu
wuy00000000000wu
uuy0000000000000
wux0000000000000
uu00000000000000
uu00tttt0000000u
uwx00tttttttt00u
vuy00000000000xv
uux00000000000yu
uu000000000000xw
uwAAAAAAAAAAAAAu
vuzzzzzzzzzzzzzu
