2124212421242322
4222422242222124
2212221222124222
bb002320000000bb
1200000000000012
2400000000000024
4400000000000044
2200000233200022
00000000000000bb
0000000000000012
0000000000000024
bb23200000000044
1200000000002322
2400000V000000bb
4400002320000012
bb00000000000024
1200000000000044
2400000000000022
bb000000000000bb
1223200000000012
24000000V0000024
4400000232000044
2200000000000022
bb000000000000bb
1200000000000012
2402320000000024
4400000000232044
2200000000000022
bb00000V000000bb
1200002332000012
2400000000000024
4400000000000044
2200000000000022
bb000000000000bb
1223200000000012
24000000V0000024
4400000232000044
2200000000000022
bb000000000000bb
1200000000000012
2402320000000024
4400000000232044
2200000000000022
bb000000V00000bb
1200002332000012
2400000000000024
4400000000000044
2200000000000022
bb002320000000bb
1200000000000012
2400000000000024
4400000000000044
2200000233200022
00000000000000bb
0000000000000012
0000000000000024
bb23200000000044
1200000000002322
24000000000000bb
4400002320000012
bb00000000000024
1200000000000044
2400000000000022
bb000000000000bb
1223200000000012
2400000000000024
4400000232000044
2200000000000022
bb000000000000bb
1200000000000012
2402320000000024
4400000000232044
4222221222124222
2322232223222212
2124212421242322
4222422242222124
2212221222124222
bb000000000000bb
1223200000000012
2400000000000024
4400000232000044
2200000000000022
00000000000000bb
0000000000000012
00000000000V0024
4423200000232044
2200000000000022
bb00000V000000bb
1200002332000012
2400000000000024
4400000000000044
2200000000000022
bb000000000000bb
1223200000000012
2400000000000024
4400000232000044
2200000000000022
00000000000000bb
0000000000000012
00000000000V0024
4423200000232044
2200000000000022
bb000000V00000bb
1200002332000012
2200000000000024
4400000000000044
2200000000000022
bb002320000000bb
1a00000000000012
2400000000000024
440000000V000044
2200000233200022
00000000000000bb
0000000000000012
0000000000000024
bb23200000000044
1200000000002322
24000000000000bb
4400002320000012
bb00000000000024
1200000000000044
2400000000000022
2322232223222322
2124212421242124
4222422242224222
